72222222222222222229
4                  6
4                  6
4                  6
4                  6
4    g22d          6
4                  6
4                  6
4                  6
4                  6
4                  6
4       7229       6
4       4  6       6
4       4  6       6
12222222222222222223
